# 格式为日文[Tab]中文[Tab]解释(可不写)，参考项目wiki
# 语义标注

[title]	[title]	场景标题，该行文本是整个场景（后续对话）的标题，非角色对话或旁白
[select]	[select]	选项文本，该行是玩家可选择的选项条目，非角色对话或旁白，通常出现在分支节点处

%r	%r	游戏使用的文本断行符，请保留，在游戏中，被分割的两段会作为上下行显示
%n	%n	游戏使用的文本换行符，请保留

# 主要角色


浩次	浩次	人名，男性，全名"粟仓浩次"（粟倉 浩次，あわくら こうじ），高中生，美弥子的弟弟，吐槽役、色狼、好色、怕姐姐但又对姐姐有强烈性欲
粟倉浩次	粟仓浩次	人名全名，男性，即"浩次"
エロガキ	色小鬼	人名代称，男性，浩次的绰号

美弥子	美弥子	人名，女性，全名"粟仓美弥子"（粟倉 美弥子，あわくら みやこ），高中生，浩次的姐姐，朱音的同学，常识人、吐槽役、对朱音的弟控行为感到无语和担忧、性格直爽、有点S倾向、喜欢调侃弟弟浩次
美弥子さん	美弥子小姐	人名，女性，美弥子的称呼
粟倉美弥子	粟仓美弥子	人名全名，女性，即"美弥子"
アネゴン	阿涅贡	人名代称，女性，美弥子的特殊绰号

粟倉	粟仓	人名姓氏，浩次和美弥子的姓氏



昭文	昭文	人名，男性，全名"智头昭文"（智頭 昭文，ちず あきふみ），高中生，朱音的弟弟，吐槽役、疲惫感、常识人、被动接受、嘴上抗拒身体诚实、纯情、容易脸红
智頭昭文	智头昭文	人名全名，男性，即"昭文"

朱音	朱音	人名，女性，全名"智头朱音"（智頭 朱音，ちず あかね），高中生，昭文的姐姐，美弥子的同学，容姿端丽、身材丰满，极度弟控、病娇倾向、表里不一，积极主动、毫无羞耻心
智頭朱音	智头朱音	人名全名，女性，即"朱音"
セクハラ大帝アネトロン	性骚扰大帝阿涅特隆	人名代称，女性，代指朱音
アネトロン	阿涅特隆	人名代称，女性，代指朱音
セクハライダー	性骚扰骑士	人名代称，女性，代指朱音
セクハラヒーロー	性骚扰英雄	人名代称，女性，代指朱音
セクハラ大帝	性骚扰大帝	人名代称，女性，代指朱音

智頭	智头	人名姓氏，昭文和朱音的姓氏



創	创	人名，男性，全名"大原创"（大原 創，おおはら はじめ），高中生，忠志的哥哥，麻耶的弟弟
大原創	大原创	人名全名，男性，即"创"

麻耶	麻耶	人名，女性，全名"大原麻耶"（大原 麻耶，おおはら まや），高中生，创和忠志的姐姐，美弥子和朱音的同学，神秘、意味深长的发言、观察力敏锐、偶尔助攻朱音
大原麻耶	大原麻耶	人名全名，女性，即"麻耶"

忠志	忠志	人名，男性，全名"大原忠志"（大原 忠志，おおはら ただし），高中生，创和麻耶的弟弟
大原忠志	大原忠志	人名全名，男性，即"忠志"

大原	大原	人名姓氏，创、麻耶和忠志的姓氏



# 其他

ダーリン	达令	亲密称谓

朱音時空	朱音时空	朱音出现时会发生的异常空间，常识完全不适用的领域
朱音空間	朱音空间	朱音出现时会发生的异常空间，常识完全不适用的领域

ノリツッコミ	即兴吐槽	昭文被姐姐逼出来的顶级吐槽技能，经过无数次朱音暴击后进化而成
夜間射撃	夜间手冲	浩次的自慰行为代称
フェニックス	不死鸟	浩次对自己阴茎的代称（反复复活）

ねえちゃん	姐姐	称呼
姉ちゃん	姐姐	称呼
お姉ちゃん	姐姐	称呼